#####################################################
#                   #     #   #        B#     #     #
# ########### ####### # # # # # ##### # # # # ### # #
# #       #   #       # # # #   #     # # # # #   # #
# # ## #### ### ####### # # ##### ##### ### # # #####
# # #     # #   #   #   # # #   #   #       #   #   #
# # # ### # # ##### # # ### # # ### ####### ##### # #
#   #   # # #     # # # #   # #   #   #   # #     # #
### ### # # ##### # # # # ### # # ### # # # # ##### #
#     # # #     #   # # #   # # #   #   #       #   #
# ##### # ### # ### # ##### # # ## #### ###### ## ###
#   #   # #   #   # # #     # # #   #       #   #   #
##### ### # # ##### # # ##### # # # # ##### # # ### #
#     #     # #     # #     # #   #     #   # #     #
# ########### # ##### ##### # ####### ### # # ##### #
# #         # #     #     # #   #   # #   # #     # #
# # ####### ####### ### ### ### # # ### ### ##### ###
# #     # #       # #   #   #   # # #   #   # #   # #
# ##### # ### ##### # # # ####### # # ### ### # ### #
#       #   #       # # #   #   # #   # # #   # #   #
# ####### # ######### ##### # # # ##### # # # # # ###
#         #                   #   #S        # #     #
#####################################################